111111111111111
1CC10000000C001
10C001111100001
10C011E0P000001
111111111111111