11111111111111111111111111
1CC10000000C00CC10000000C1
10C00111110000CC00000M00C1
10C011E0P00000CC100M0000C1
11111111111111111111111111