111111111111111
10010000000C001
1P0001111100001
100011E00000001
111111111111111