111111111111111
10C10000000C0E1
1PC00111110M001
10C011E00000001
111111111111111